6 10
1 1 1 1 1 1 1 1 1 1
1 0 0 0 0 0 0 0 0 x
e 0 0 0 0 0 0 0 0 1
1 0 0 0 0 0 0 0 0 1
1 0 0 0 0 0 0 0 0 1
1 1 1 1 1 1 1 1 1 1